,Unnamed: 0,Hospitals,Social Facilities,Clinics,Pharmacies,Doctors,total
0,Vancouver,4,22,61,115,12,214
1,Kelowna,1,1,3,14,2,21
2,Abbotsford,1,49,29,47,64,190
3,Victoria,1,13,4,17,3,38
4,Kamloops,3,11,5,13,5,37
5,Nanaimo,1,6,7,10,1,25
6,Chilliwack,1,5,3,6,2,17
7,Vernon,1,12,3,4,1,21
8,Campbell River,2,4,6,2,1,15
9,Penticton,1,2,1,3,1,8
