,Unnamed: 0,Hospitals,Social Facilities,Clinics,Pharmacies,Doctors,total
0,Vancouver,3,16,62,113,12,206
1,Kelowna,1,1,3,12,2,19
2,Abbotsford,0,32,29,47,63,171
3,Victoria,1,1,4,18,3,27
4,Kamloops,0,4,5,12,5,26
5,Nanaimo,1,5,7,9,0,22
6,Chilliwack,0,3,3,6,2,14
7,Vernon,0,2,3,4,1,10
8,Campbell River,0,1,6,2,1,10
9,Penticton,0,0,1,3,1,5
